Adventure: Finding new excitements
Independence: Living without routine assistance
Appearance: Beauty, presence, and fashion
Boldness: Doing what few dare to do
Compassion: Easing the pains of strangers
Challenge: Pushing yourself, regardless of the goal
Community: Being part of a wider group
Competency: Building skills in a particular field
Visual Arts and Crafts: Creating or admiring
Curiosity: Finding new ideas
Determination: Finishing what you start
Faith: Connection to something beyond humanity
Fame: Being known to all
Friendships: Deep relationships with a select few
Influence: Power over others
Justice: Righting the wrongs you see
Kindness: Supporting the needs of others
Leadership: People turning to you for guidance
Learning: Amassing knowledge and skills
Love: Finding people to share your heart with
Performing Arts: Attending or performing
Work: Fulfilling employment
Peace: Peace within yourself
Pleasure: Treating yourself well
Popularity: Being liked, but not perhaps known, by a large group
Religion: The routine and structure, as opposed to Faith
Reputation: The things strangers know you for
Responsibility: Being entrusted by others
Stability: Confidence that next week will be like this week
Sports: Attending or playing
Keeping Fit: Exercise for the sake of health
Quiet Hobbies: Occupied moments of calm